Sem dÃºvidas, O produto Ã© exatamente como descrito Recomendo!	Positiva
Com certeza, Produto veio com defeito Recomendo!	Negativa
Sem dÃºvidas, Entrega muito lenta ğŸ˜Š	Negativa
Honestamente, A qualidade Ã© muito boa!	Positiva
ExperiÃªncia de compra maravilhosa!	Positiva
Honestamente, Produto chegou em perfeito estado!	Positiva
Entrega muito lenta!	Negativa
Com certeza, Demorou muito para entregar Muito bom!	Negativa
Sem dÃºvidas, Atendimento excelente, estou muito satisfeito Muito bom!	Positiva
Falta de informaÃ§Ãµes claras ğŸ˜Š	Negativa
Site fÃ¡cil de navegar e comprar.	Positiva
PÃ©ssima experiÃªncia, nÃ£o recomendo!	Negativa
Honestamente, Produto veio com defeito Muito bom!	Negativa
Com certeza, Entrega atrasada, fiquei frustrado!	Negativa
Com certeza, Suporte muito atencioso e prestativo!	Positiva
Sem dÃºvidas, Suporte demorou para responder Recomendo!	Negativa
Sem dÃºvidas, Demorou muito para entregar.	Negativa
Fiquei muito satisfeito com o atendimento!	Positiva
Honestamente, Produto chegou antes do prazo!	Positiva
Honestamente, Ã“tima experiÃªncia de compra Muito bom!	Positiva
Honestamente, Produto veio com defeito ğŸ˜Š	Negativa
Sem dÃºvidas, Entrega atrasada, fiquei frustrado.	Negativa
Produto chegou em perfeito estado!	Positiva
Recomendo a todos ğŸ˜Š	Positiva
Honestamente, Entrega atrasada, fiquei frustrado Muito bom!	Negativa
Com certeza, Entrega atrasada, fiquei frustrado.	Negativa
Com certeza, Produto veio com defeito!	Negativa
Com certeza, NÃ£o recomendo esse vendedor Recomendo!	Negativa
Com certeza, Recomendo para todos os amigos!	Positiva
Honestamente, Atendimento ruim e pouco eficiente!	Negativa
Com certeza, Muito bom, vale a pena Recomendo!	Positiva
Honestamente, Muito feliz com a compra realizada ğŸ˜Š	Positiva
Com certeza, Entrega muito lenta!	Negativa
Honestamente, Recomendo para todos os amigos Muito bom!	Positiva
Com certeza, NÃ£o recomendo esse vendedor ğŸ˜Š	Negativa
Recomendo para todos os amigos Recomendo!	Positiva
Entrega rÃ¡pida e eficiente, adorei!	Positiva
Honestamente, Site fÃ¡cil de navegar e comprar.	Positiva
Sem dÃºvidas, Entrega atrasada, fiquei frustrado ğŸ˜Š	Negativa
Sem dÃºvidas, Site travou vÃ¡rias vezes Recomendo!	Negativa
NÃ£o gostei da qualidade do produto Muito bom!	Negativa
Honestamente, PÃ©ssima experiÃªncia, nÃ£o recomendo Recomendo!	Negativa
Sem dÃºvidas, Atendimento ruim e pouco eficiente.	Negativa
Com certeza, NÃ£o resolveram meu problema!	Negativa
Sem dÃºvidas, NÃ£o recomendo esse vendedor Muito bom!	Negativa
Honestamente, Produto superou minhas expectativas ğŸ˜Š	Positiva
Falta de informaÃ§Ãµes claras.	Negativa
Com certeza, PÃ©ssima experiÃªncia, nÃ£o recomendo!	Negativa
Com certeza, Recomendo a todos ğŸ˜Š	Positiva
Sem dÃºvidas, Produto veio com defeito!	Negativa
Atendimento ao cliente deixou a desejar.	Negativa
Produto chegou danificado Recomendo!	Negativa
Sem dÃºvidas, Entrega rÃ¡pida e eficiente, adorei.	Positiva
Sem dÃºvidas, Produto nÃ£o funcionou como esperado!	Negativa
Com certeza, Produto nÃ£o funcionou como esperado Recomendo!	Negativa
Com certeza, Produto diferente do anunciado Recomendo!	Negativa
Com certeza, Produto chegou com defeito Muito bom!	Negativa
Produto chegou antes do prazo Muito bom!	Positiva
Com certeza, Produto nÃ£o corresponde Ã  descriÃ§Ã£o.	Negativa
Produto superou minhas expectativas.	Positiva
Comprei e fiquei muito feliz Muito bom!	Positiva
Honestamente, Produto chegou danificado!	Negativa
Honestamente, Site fÃ¡cil de navegar e comprar ğŸ˜Š	Positiva
Muito bom, vale a pena.	Positiva
Sem dÃºvidas, Voltarei a comprar com certeza ğŸ˜Š	Positiva
Honestamente, Atendimento excelente, estou muito satisfeito Muito bom!	Positiva
Site travou vÃ¡rias vezes ğŸ˜Š	Negativa
Sem dÃºvidas, NÃ£o resolveram meu problema ğŸ˜Š	Negativa
Com certeza, Recomendo para todos os amigos Muito bom!	Positiva
Com certeza, Gostei muito da qualidade do produto Recomendo!	Positiva
Honestamente, ExperiÃªncia de compra maravilhosa Recomendo!	Positiva
Produto chegou danificado Muito bom!	Negativa
Com certeza, Recomendo para todos os amigos ğŸ˜Š	Positiva
Sem dÃºvidas, Atendimento ruim e pouco eficiente ğŸ˜Š	Negativa
Produto chegou em perfeito estado Recomendo!	Positiva
Comprei e fiquei muito feliz.	Positiva
Com certeza, Produto chegou em perfeito estado Recomendo!	Positiva
Sem dÃºvidas, Site com muitas falhas, difÃ­cil comprar Muito bom!	Negativa
Honestamente, Fiquei muito satisfeito com o atendimento ğŸ˜Š	Positiva
Com certeza, Ã“tima experiÃªncia de compra Recomendo!	Positiva
Produto diferente do anunciado Muito bom!	Negativa
Voltarei a comprar com certeza ğŸ˜Š	Positiva
Com certeza, Produto nÃ£o corresponde Ã  descriÃ§Ã£o Recomendo!	Negativa
Honestamente, Produto chegou antes do prazo Recomendo!	Positiva
Com certeza, Produto superou minhas expectativas!	Positiva
NÃ£o recomendo esse vendedor!	Negativa
Sem dÃºvidas, Atendimento ruim e pouco eficiente!	Negativa
Demorou muito para entregar.	Negativa
Com certeza, A qualidade Ã© muito boa Recomendo!	Positiva
Sem dÃºvidas, Gostei muito da qualidade do produto Muito bom!	Positiva
Site com muitas falhas, difÃ­cil comprar Recomendo!	Negativa
Muito bom, vale a pena ğŸ˜Š	Positiva
Honestamente, Atendimento excelente, estou muito satisfeito Recomendo!	Positiva
Sem dÃºvidas, Atendimento excelente, estou muito satisfeito Recomendo!	Positiva
Com certeza, Site travou vÃ¡rias vezes!	Negativa
Com certeza, Entrega atrasada, fiquei frustrado Recomendo!	Negativa
Produto chegou danificado!	Negativa
Sem dÃºvidas, Atendimento ao cliente deixou a desejar Muito bom!	Negativa
Sem dÃºvidas, Produto diferente do anunciado ğŸ˜Š	Negativa
Com certeza, Fiquei decepcionado com a compra!	Negativa
Sem dÃºvidas, Recomendo para todos os amigos ğŸ˜Š	Positiva
Sem dÃºvidas, Voltarei a comprar com certeza.	Positiva
Fiquei decepcionado com a compra Recomendo!	Negativa
Atendimento excelente, estou muito satisfeito.	Positiva
Com certeza, Comprei e fiquei muito feliz Recomendo!	Positiva
Honestamente, Produto chegou antes do prazo.	Positiva
Atendimento ao cliente deixou a desejar Muito bom!	Negativa
Sem dÃºvidas, Suporte muito atencioso e prestativo Recomendo!	Positiva
Sem dÃºvidas, Falta de informaÃ§Ãµes claras.	Negativa
NÃ£o gostei da qualidade do produto Recomendo!	Negativa
Sem dÃºvidas, Comprei e fiquei muito feliz!	Positiva
Com certeza, Fiquei decepcionado com a compra.	Negativa
O produto Ã© exatamente como descrito!	Positiva
Com certeza, Atendimento ao cliente deixou a desejar Muito bom!	Negativa
Sem dÃºvidas, Site com muitas falhas, difÃ­cil comprar ğŸ˜Š	Negativa
Com certeza, Comprei e fiquei muito feliz!	Positiva
Sem dÃºvidas, Recomendo a todos!	Positiva
Com certeza, Ã“tima experiÃªncia de compra ğŸ˜Š	Positiva
A qualidade Ã© muito boa!	Positiva
Sem dÃºvidas, NÃ£o gostei da qualidade do produto Recomendo!	Negativa
Sem dÃºvidas, Muito feliz com a compra realizada.	Positiva
A qualidade Ã© muito boa Recomendo!	Positiva
Entrega atrasada, fiquei frustrado ğŸ˜Š	Negativa
Sem dÃºvidas, Produto chegou antes do prazo.	Positiva
Honestamente, Muito bom, vale a pena Muito bom!	Positiva
Com certeza, Produto nÃ£o corresponde Ã  descriÃ§Ã£o ğŸ˜Š	Negativa
Com certeza, Entrega rÃ¡pida e eficiente, adorei ğŸ˜Š	Positiva
Produto nÃ£o corresponde Ã  descriÃ§Ã£o Recomendo!	Negativa
A qualidade Ã© muito boa ğŸ˜Š	Positiva
Honestamente, NÃ£o gostei da qualidade do produto.	Negativa
Ã“tima experiÃªncia de compra Muito bom!	Positiva
Sem dÃºvidas, Suporte tÃ©cnico resolveu meu problema rÃ¡pido.	Positiva
Honestamente, Produto nÃ£o funcionou como esperado Muito bom!	Negativa
Sem dÃºvidas, Comprei e fiquei muito feliz Muito bom!	Positiva
Com certeza, NÃ£o gostei da qualidade do produto Muito bom!	Negativa
Honestamente, Recomendo a todos!	Positiva
Com certeza, Produto chegou em perfeito estado!	Positiva
Com certeza, Falta de informaÃ§Ãµes claras ğŸ˜Š	Negativa
Com certeza, NÃ£o resolveram meu problema ğŸ˜Š	Negativa
Com certeza, Produto chegou com defeito ğŸ˜Š	Negativa
NÃ£o resolveram meu problema Recomendo!	Negativa
Com certeza, Produto nÃ£o funcionou como esperado!	Negativa
Sem dÃºvidas, A qualidade Ã© muito boa.	Positiva
Honestamente, A qualidade Ã© muito boa Muito bom!	Positiva
Honestamente, Site fÃ¡cil de navegar e comprar Recomendo!	Positiva
Demorou muito para entregar Muito bom!	Negativa
Recomendo para todos os amigos.	Positiva
Sem dÃºvidas, Ã“tima experiÃªncia de compra.	Positiva
Com certeza, Recomendo a todos!	Positiva
Honestamente, Atendimento ao cliente deixou a desejar Recomendo!	Negativa
Falta de informaÃ§Ãµes claras Muito bom!	Negativa
Com certeza, Atendimento ao cliente deixou a desejar ğŸ˜Š	Negativa
Sem dÃºvidas, Site com muitas falhas, difÃ­cil comprar!	Negativa
Com certeza, Atendimento ruim e pouco eficiente!	Negativa
Fiquei decepcionado com a compra.	Negativa
Sem dÃºvidas, Recomendo a todos Recomendo!	Positiva
Com certeza, Produto veio com defeito ğŸ˜Š	Negativa
Honestamente, ExperiÃªncia de compra maravilhosa Muito bom!	Positiva
Honestamente, NÃ£o gostei da qualidade do produto ğŸ˜Š	Negativa
Honestamente, Produto veio com defeito Recomendo!	Negativa
Com certeza, Produto chegou antes do prazo Muito bom!	Positiva
Sem dÃºvidas, Muito feliz com a compra realizada ğŸ˜Š	Positiva
Com certeza, Atendimento ao cliente deixou a desejar!	Negativa
Honestamente, Atendimento ruim e pouco eficiente.	Negativa
Honestamente, Produto nÃ£o funcionou como esperado Recomendo!	Negativa
Com certeza, Fiquei muito satisfeito com o atendimento ğŸ˜Š	Positiva
Honestamente, Gostei muito da qualidade do produto Muito bom!	Positiva
Fiquei decepcionado com a compra ğŸ˜Š	Negativa
Sem dÃºvidas, A qualidade Ã© muito boa Recomendo!	Positiva
Com certeza, Gostei muito da qualidade do produto Muito bom!	Positiva
Sem dÃºvidas, Site fÃ¡cil de navegar e comprar!	Positiva
Gostei muito da qualidade do produto Recomendo!	Positiva
Produto veio com defeito Muito bom!	Negativa
Sem dÃºvidas, Site travou vÃ¡rias vezes.	Negativa
Sem dÃºvidas, Fiquei muito satisfeito com o atendimento!	Positiva
Com certeza, Produto veio com defeito.	Negativa
NÃ£o resolveram meu problema ğŸ˜Š	Negativa
Suporte tÃ©cnico resolveu meu problema rÃ¡pido Muito bom!	Positiva
Produto superou minhas expectativas Recomendo!	Positiva
Honestamente, Falta de informaÃ§Ãµes claras!	Negativa
Com certeza, Suporte muito atencioso e prestativo Recomendo!	Positiva
Com certeza, Atendimento ruim e pouco eficiente Recomendo!	Negativa
Sem dÃºvidas, Produto chegou em perfeito estado Muito bom!	Positiva
Produto chegou em perfeito estado.	Positiva
Recomendo a todos.	Positiva
NÃ£o gostei da qualidade do produto ğŸ˜Š	Negativa
Honestamente, Atendimento ao cliente deixou a desejar ğŸ˜Š	Negativa
Honestamente, Fiquei muito satisfeito com o atendimento Recomendo!	Positiva
Honestamente, Entrega rÃ¡pida e eficiente, adorei.	Positiva
Produto chegou com defeito ğŸ˜Š	Negativa
Honestamente, Voltarei a comprar com certeza!	Positiva
Com certeza, Fiquei muito satisfeito com o atendimento.	Positiva
Sem dÃºvidas, PÃ©ssima experiÃªncia, nÃ£o recomendo ğŸ˜Š	Negativa
Honestamente, Site fÃ¡cil de navegar e comprar!	Positiva
Sem dÃºvidas, Produto chegou danificado Recomendo!	Negativa
Honestamente, Recomendo para todos os amigos!	Positiva
Sem dÃºvidas, Produto nÃ£o funcionou como esperado.	Negativa
Com certeza, Atendimento ao cliente deixou a desejar Recomendo!	Negativa
Sem dÃºvidas, Suporte tÃ©cnico resolveu meu problema rÃ¡pido ğŸ˜Š	Positiva
Com certeza, Voltarei a comprar com certeza.	Positiva
Com certeza, Produto nÃ£o funcionou como esperado Muito bom!	Negativa
Com certeza, Produto chegou antes do prazo.	Positiva
Com certeza, Entrega rÃ¡pida e eficiente, adorei Muito bom!	Positiva
Com certeza, Entrega rÃ¡pida e eficiente, adorei!	Positiva
Com certeza, Demorou muito para entregar!	Negativa
Honestamente, Entrega atrasada, fiquei frustrado Recomendo!	Negativa
Honestamente, Produto chegou com defeito Muito bom!	Negativa
Sem dÃºvidas, NÃ£o recomendo esse vendedor.	Negativa
Honestamente, Produto veio com defeito!	Negativa
Fiquei muito satisfeito com o atendimento Recomendo!	Positiva
Honestamente, Site com muitas falhas, difÃ­cil comprar Muito bom!	Negativa
Gostei muito da qualidade do produto Muito bom!	Positiva
NÃ£o gostei da qualidade do produto.	Negativa
Com certeza, Suporte demorou para responder Recomendo!	Negativa
Com certeza, Produto nÃ£o funcionou como esperado ğŸ˜Š	Negativa
Atendimento excelente, estou muito satisfeito Recomendo!	Positiva
PÃ©ssima experiÃªncia, nÃ£o recomendo.	Negativa
Com certeza, Comprei e fiquei muito feliz Muito bom!	Positiva
Honestamente, NÃ£o gostei da qualidade do produto Recomendo!	Negativa
Gostei muito da qualidade do produto!	Positiva
Site travou vÃ¡rias vezes Recomendo!	Negativa
Com certeza, Site com muitas falhas, difÃ­cil comprar Muito bom!	Negativa
Sem dÃºvidas, Fiquei decepcionado com a compra Recomendo!	Negativa
Sem dÃºvidas, Gostei muito da qualidade do produto ğŸ˜Š	Positiva
Sem dÃºvidas, Site com muitas falhas, difÃ­cil comprar Recomendo!	Negativa
Sem dÃºvidas, Atendimento ao cliente deixou a desejar!	Negativa
Honestamente, Falta de informaÃ§Ãµes claras.	Negativa
Ã“tima experiÃªncia de compra Recomendo!	Positiva
Entrega muito lenta Muito bom!	Negativa
Sem dÃºvidas, Site travou vÃ¡rias vezes Muito bom!	Negativa
Sem dÃºvidas, Produto chegou com defeito!	Negativa
Demorou muito para entregar ğŸ˜Š	Negativa
Honestamente, Atendimento ruim e pouco eficiente Muito bom!	Negativa
Fiquei muito satisfeito com o atendimento ğŸ˜Š	Positiva
Suporte demorou para responder ğŸ˜Š	Negativa
Honestamente, Suporte tÃ©cnico resolveu meu problema rÃ¡pido Recomendo!	Positiva
Honestamente, Site travou vÃ¡rias vezes Recomendo!	Negativa
Sem dÃºvidas, Produto nÃ£o corresponde Ã  descriÃ§Ã£o.	Negativa
Sem dÃºvidas, A qualidade Ã© muito boa!	Positiva
Produto veio com defeito.	Negativa
Com certeza, Produto chegou em perfeito estado.	Positiva
Entrega rÃ¡pida e eficiente, adorei Muito bom!	Positiva
Suporte tÃ©cnico resolveu meu problema rÃ¡pido!	Positiva
Com certeza, Site com muitas falhas, difÃ­cil comprar!	Negativa
Sem dÃºvidas, Ã“tima experiÃªncia de compra Muito bom!	Positiva
Honestamente, NÃ£o recomendo esse vendedor Recomendo!	Negativa
NÃ£o gostei da qualidade do produto!	Negativa
Suporte muito atencioso e prestativo!	Positiva
Honestamente, Atendimento ruim e pouco eficiente Recomendo!	Negativa
Sem dÃºvidas, Voltarei a comprar com certeza Recomendo!	Positiva
Suporte demorou para responder Recomendo!	Negativa
Recomendo a todos Recomendo!	Positiva
Honestamente, Demorou muito para entregar Recomendo!	Negativa
Honestamente, O produto Ã© exatamente como descrito!	Positiva
Honestamente, Produto superou minhas expectativas Muito bom!	Positiva
Honestamente, Entrega rÃ¡pida e eficiente, adorei Muito bom!	Positiva
Produto nÃ£o funcionou como esperado ğŸ˜Š	Negativa
Produto chegou com defeito Muito bom!	Negativa
Honestamente, Recomendo para todos os amigos.	Positiva
Produto superou minhas expectativas Muito bom!	Positiva
Honestamente, Entrega rÃ¡pida e eficiente, adorei Recomendo!	Positiva
Honestamente, A qualidade Ã© muito boa.	Positiva
Entrega atrasada, fiquei frustrado Muito bom!	Negativa
Honestamente, NÃ£o recomendo esse vendedor.	Negativa
Sem dÃºvidas, O produto Ã© exatamente como descrito Muito bom!	Positiva
Sem dÃºvidas, Produto chegou danificado ğŸ˜Š	Negativa
Produto chegou com defeito Recomendo!	Negativa
Com certeza, O produto Ã© exatamente como descrito.	Positiva
Entrega rÃ¡pida e eficiente, adorei.	Positiva
Honestamente, Produto chegou com defeito Recomendo!	Negativa
Fiquei decepcionado com a compra Muito bom!	Negativa
Site com muitas falhas, difÃ­cil comprar!	Negativa
Produto nÃ£o corresponde Ã  descriÃ§Ã£o ğŸ˜Š	Negativa
Honestamente, Produto nÃ£o corresponde Ã  descriÃ§Ã£o ğŸ˜Š	Negativa
Sem dÃºvidas, NÃ£o resolveram meu problema.	Negativa
Atendimento ao cliente deixou a desejar Recomendo!	Negativa
Suporte muito atencioso e prestativo ğŸ˜Š	Positiva
Honestamente, Gostei muito da qualidade do produto ğŸ˜Š	Positiva
Entrega rÃ¡pida e eficiente, adorei ğŸ˜Š	Positiva
Com certeza, Site fÃ¡cil de navegar e comprar Muito bom!	Positiva
Com certeza, Atendimento excelente, estou muito satisfeito!	Positiva
Produto chegou com defeito!	Negativa
Honestamente, Produto diferente do anunciado ğŸ˜Š	Negativa
Sem dÃºvidas, Entrega rÃ¡pida e eficiente, adorei Muito bom!	Positiva
Honestamente, Fiquei decepcionado com a compra.	Negativa
Atendimento excelente, estou muito satisfeito!	Positiva
Honestamente, Site com muitas falhas, difÃ­cil comprar.	Negativa
Sem dÃºvidas, Recomendo a todos ğŸ˜Š	Positiva
Com certeza, Produto chegou antes do prazo Recomendo!	Positiva
Honestamente, Produto chegou em perfeito estado.	Positiva
Com certeza, Produto superou minhas expectativas Recomendo!	Positiva
Demorou muito para entregar Recomendo!	Negativa
Com certeza, Produto chegou antes do prazo ğŸ˜Š	Positiva
Com certeza, Voltarei a comprar com certeza Recomendo!	Positiva
Sem dÃºvidas, PÃ©ssima experiÃªncia, nÃ£o recomendo Muito bom!	Negativa
Honestamente, Recomendo a todos.	Positiva
Produto veio com defeito ğŸ˜Š	Negativa
Sem dÃºvidas, Atendimento ruim e pouco eficiente Muito bom!	Negativa
Com certeza, NÃ£o recomendo esse vendedor Muito bom!	Negativa
Produto chegou com defeito.	Negativa
Sem dÃºvidas, Falta de informaÃ§Ãµes claras Recomendo!	Negativa
Sem dÃºvidas, Recomendo para todos os amigos Recomendo!	Positiva
Produto superou minhas expectativas ğŸ˜Š	Positiva
Atendimento ruim e pouco eficiente Muito bom!	Negativa
Sem dÃºvidas, ExperiÃªncia de compra maravilhosa!	Positiva
Com certeza, NÃ£o resolveram meu problema Recomendo!	Negativa
Sem dÃºvidas, Demorou muito para entregar Recomendo!	Negativa
Com certeza, Atendimento ruim e pouco eficiente ğŸ˜Š	Negativa
Honestamente, Recomendo a todos Recomendo!	Positiva
Recomendo a todos!	Positiva
Fiquei muito satisfeito com o atendimento.	Positiva
Sem dÃºvidas, Recomendo para todos os amigos!	Positiva
Honestamente, Ã“tima experiÃªncia de compra ğŸ˜Š	Positiva
Honestamente, Entrega atrasada, fiquei frustrado.	Negativa
Produto chegou antes do prazo.	Positiva
Com certeza, NÃ£o recomendo esse vendedor.	Negativa
Com certeza, Produto nÃ£o funcionou como esperado.	Negativa
Com certeza, Suporte tÃ©cnico resolveu meu problema rÃ¡pido!	Positiva
Sem dÃºvidas, Produto superou minhas expectativas ğŸ˜Š	Positiva
Com certeza, NÃ£o recomendo esse vendedor!	Negativa
Com certeza, Produto chegou em perfeito estado Muito bom!	Positiva
Com certeza, Voltarei a comprar com certeza!	Positiva
Honestamente, Muito feliz com a compra realizada!	Positiva
Produto chegou danificado.	Negativa
Com certeza, Muito bom, vale a pena ğŸ˜Š	Positiva
Com certeza, Atendimento excelente, estou muito satisfeito Recomendo!	Positiva
Sem dÃºvidas, Produto superou minhas expectativas Muito bom!	Positiva
Honestamente, Produto diferente do anunciado Recomendo!	Negativa
Honestamente, Produto chegou danificado Muito bom!	Negativa
Honestamente, Produto chegou antes do prazo Muito bom!	Positiva
Com certeza, A qualidade Ã© muito boa Muito bom!	Positiva
Honestamente, Fiquei decepcionado com a compra!	Negativa
Com certeza, Fiquei decepcionado com a compra Recomendo!	Negativa
Com certeza, Suporte demorou para responder.	Negativa
Com certeza, Recomendo para todos os amigos Recomendo!	Positiva
Com certeza, ExperiÃªncia de compra maravilhosa ğŸ˜Š	Positiva
Honestamente, Atendimento ao cliente deixou a desejar Muito bom!	Negativa
Produto nÃ£o corresponde Ã  descriÃ§Ã£o!	Negativa
Sem dÃºvidas, Produto chegou em perfeito estado.	Positiva
Com certeza, Atendimento excelente, estou muito satisfeito Muito bom!	Positiva
Com certeza, ExperiÃªncia de compra maravilhosa!	Positiva
Honestamente, Produto diferente do anunciado Muito bom!	Negativa
Honestamente, Comprei e fiquei muito feliz ğŸ˜Š	Positiva
Sem dÃºvidas, Falta de informaÃ§Ãµes claras Muito bom!	Negativa
Muito feliz com a compra realizada!	Positiva
Sem dÃºvidas, Suporte tÃ©cnico resolveu meu problema rÃ¡pido!	Positiva
Com certeza, Site travou vÃ¡rias vezes Muito bom!	Negativa
Sem dÃºvidas, Gostei muito da qualidade do produto.	Positiva
Produto diferente do anunciado!	Negativa
Honestamente, Produto chegou com defeito.	Negativa
Com certeza, Produto diferente do anunciado.	Negativa
Sem dÃºvidas, Atendimento ao cliente deixou a desejar ğŸ˜Š	Negativa
Entrega rÃ¡pida e eficiente, adorei Recomendo!	Positiva
Sem dÃºvidas, Entrega muito lenta Muito bom!	Negativa
Com certeza, Recomendo para todos os amigos.	Positiva
Honestamente, Fiquei muito satisfeito com o atendimento.	Positiva
Muito feliz com a compra realizada Muito bom!	Positiva
Com certeza, Demorou muito para entregar ğŸ˜Š	Negativa
Sem dÃºvidas, Atendimento excelente, estou muito satisfeito.	Positiva
Com certeza, Atendimento excelente, estou muito satisfeito.	Positiva
ExperiÃªncia de compra maravilhosa Muito bom!	Positiva
A qualidade Ã© muito boa.	Positiva
Com certeza, Gostei muito da qualidade do produto.	Positiva
Recomendo para todos os amigos Muito bom!	Positiva
Com certeza, NÃ£o resolveram meu problema Muito bom!	Negativa
Com certeza, Atendimento ruim e pouco eficiente.	Negativa
Com certeza, Falta de informaÃ§Ãµes claras.	Negativa
Honestamente, Entrega atrasada, fiquei frustrado!	Negativa
Produto veio com defeito Recomendo!	Negativa
Sem dÃºvidas, Entrega atrasada, fiquei frustrado Muito bom!	Negativa
Suporte tÃ©cnico resolveu meu problema rÃ¡pido ğŸ˜Š	Positiva
Sem dÃºvidas, NÃ£o resolveram meu problema Recomendo!	Negativa
Site fÃ¡cil de navegar e comprar!	Positiva
Produto nÃ£o funcionou como esperado Recomendo!	Negativa
Produto nÃ£o funcionou como esperado.	Negativa
Voltarei a comprar com certeza!	Positiva
Com certeza, O produto Ã© exatamente como descrito ğŸ˜Š	Positiva
Sem dÃºvidas, Atendimento excelente, estou muito satisfeito ğŸ˜Š	Positiva
Atendimento ruim e pouco eficiente ğŸ˜Š	Negativa
Com certeza, A qualidade Ã© muito boa.	Positiva
Sem dÃºvidas, Produto chegou em perfeito estado ğŸ˜Š	Positiva
Com certeza, Entrega atrasada, fiquei frustrado ğŸ˜Š	Negativa
Honestamente, Gostei muito da qualidade do produto.	Positiva
Sem dÃºvidas, Produto chegou danificado!	Negativa
Atendimento ruim e pouco eficiente!	Negativa
Sem dÃºvidas, Comprei e fiquei muito feliz.	Positiva
Com certeza, Produto chegou danificado Recomendo!	Negativa
Honestamente, Muito bom, vale a pena ğŸ˜Š	Positiva
A qualidade Ã© muito boa Muito bom!	Positiva
Sem dÃºvidas, Entrega rÃ¡pida e eficiente, adorei!	Positiva
Honestamente, Suporte tÃ©cnico resolveu meu problema rÃ¡pido Muito bom!	Positiva
Honestamente, Demorou muito para entregar.	Negativa
Com certeza, Fiquei muito satisfeito com o atendimento!	Positiva
Honestamente, Suporte demorou para responder ğŸ˜Š	Negativa
Sem dÃºvidas, Fiquei decepcionado com a compra Muito bom!	Negativa
Com certeza, Produto superou minhas expectativas ğŸ˜Š	Positiva
Sem dÃºvidas, Fiquei muito satisfeito com o atendimento Muito bom!	Positiva
Sem dÃºvidas, Gostei muito da qualidade do produto!	Positiva
Com certeza, Muito bom, vale a pena Muito bom!	Positiva
Sem dÃºvidas, Suporte demorou para responder!	Negativa
Honestamente, Atendimento excelente, estou muito satisfeito.	Positiva
Com certeza, NÃ£o gostei da qualidade do produto ğŸ˜Š	Negativa
Sem dÃºvidas, Produto nÃ£o funcionou como esperado ğŸ˜Š	Negativa
Sem dÃºvidas, Suporte demorou para responder.	Negativa
Honestamente, Fiquei decepcionado com a compra Recomendo!	Negativa
Honestamente, Voltarei a comprar com certeza.	Positiva
Site fÃ¡cil de navegar e comprar Muito bom!	Positiva
Com certeza, Site fÃ¡cil de navegar e comprar!	Positiva
Com certeza, Produto nÃ£o corresponde Ã  descriÃ§Ã£o!	Negativa
Com certeza, ExperiÃªncia de compra maravilhosa Muito bom!	Positiva
Honestamente, Produto nÃ£o corresponde Ã  descriÃ§Ã£o.	Negativa
Suporte demorou para responder Muito bom!	Negativa
Com certeza, Ã“tima experiÃªncia de compra.	Positiva
Produto nÃ£o corresponde Ã  descriÃ§Ã£o Muito bom!	Negativa
Honestamente, Suporte tÃ©cnico resolveu meu problema rÃ¡pido ğŸ˜Š	Positiva
Sem dÃºvidas, Entrega rÃ¡pida e eficiente, adorei Recomendo!	Positiva
Sem dÃºvidas, Entrega muito lenta Recomendo!	Negativa
Sem dÃºvidas, Produto nÃ£o funcionou como esperado Recomendo!	Negativa
Sem dÃºvidas, Produto superou minhas expectativas!	Positiva
Site fÃ¡cil de navegar e comprar Recomendo!	Positiva
Sem dÃºvidas, NÃ£o recomendo esse vendedor ğŸ˜Š	Negativa
Honestamente, Comprei e fiquei muito feliz!	Positiva
Honestamente, Recomendo a todos ğŸ˜Š	Positiva
Com certeza, Produto chegou com defeito Recomendo!	Negativa
Sem dÃºvidas, Entrega rÃ¡pida e eficiente, adorei ğŸ˜Š	Positiva
Com certeza, Falta de informaÃ§Ãµes claras Recomendo!	Negativa
Ã“tima experiÃªncia de compra!	Positiva
Honestamente, Produto chegou com defeito ğŸ˜Š	Negativa
O produto Ã© exatamente como descrito Muito bom!	Positiva
Sem dÃºvidas, Ã“tima experiÃªncia de compra Recomendo!	Positiva
Sem dÃºvidas, Produto chegou em perfeito estado!	Positiva
Honestamente, Suporte demorou para responder Recomendo!	Negativa
Honestamente, Produto superou minhas expectativas Recomendo!	Positiva
Voltarei a comprar com certeza Recomendo!	Positiva
Com certeza, Muito feliz com a compra realizada ğŸ˜Š	Positiva
Honestamente, NÃ£o recomendo esse vendedor Muito bom!	Negativa
Sem dÃºvidas, Falta de informaÃ§Ãµes claras ğŸ˜Š	Negativa
Com certeza, Entrega muito lenta Recomendo!	Negativa
Sem dÃºvidas, Produto nÃ£o corresponde Ã  descriÃ§Ã£o!	Negativa
Demorou muito para entregar!	Negativa
Com certeza, Atendimento excelente, estou muito satisfeito ğŸ˜Š	Positiva
Sem dÃºvidas, Produto veio com defeito Muito bom!	Negativa
Honestamente, Produto chegou com defeito!	Negativa
Sem dÃºvidas, Produto diferente do anunciado!	Negativa
Com certeza, Entrega muito lenta Muito bom!	Negativa
Com certeza, Recomendo a todos.	Positiva
Honestamente, Entrega muito lenta ğŸ˜Š	Negativa
Produto veio com defeito!	Negativa
Honestamente, Muito feliz com a compra realizada.	Positiva
Honestamente, Atendimento excelente, estou muito satisfeito!	Positiva
Sem dÃºvidas, Falta de informaÃ§Ãµes claras!	Negativa
Honestamente, Site com muitas falhas, difÃ­cil comprar Recomendo!	Negativa
Honestamente, O produto Ã© exatamente como descrito Recomendo!	Positiva
Honestamente, A qualidade Ã© muito boa ğŸ˜Š	Positiva
Site travou vÃ¡rias vezes Muito bom!	Negativa
Com certeza, Entrega rÃ¡pida e eficiente, adorei.	Positiva
Voltarei a comprar com certeza Muito bom!	Positiva
Sem dÃºvidas, Produto veio com defeito ğŸ˜Š	Negativa
Com certeza, Recomendo a todos Muito bom!	Positiva
Sem dÃºvidas, Produto veio com defeito Recomendo!	Negativa
Honestamente, Fiquei muito satisfeito com o atendimento Muito bom!	Positiva
Com certeza, Site fÃ¡cil de navegar e comprar Recomendo!	Positiva
Honestamente, NÃ£o resolveram meu problema Recomendo!	Negativa
Sem dÃºvidas, Fiquei muito satisfeito com o atendimento Recomendo!	Positiva
Com certeza, Muito bom, vale a pena!	Positiva
Produto chegou antes do prazo!	Positiva
Recomendo para todos os amigos!	Positiva
Com certeza, Produto diferente do anunciado Muito bom!	Negativa
Honestamente, Produto diferente do anunciado.	Negativa
Sem dÃºvidas, Suporte demorou para responder ğŸ˜Š	Negativa
PÃ©ssima experiÃªncia, nÃ£o recomendo Recomendo!	Negativa
Com certeza, Recomendo a todos Recomendo!	Positiva
Muito feliz com a compra realizada ğŸ˜Š	Positiva
Sem dÃºvidas, O produto Ã© exatamente como descrito!	Positiva
Site travou vÃ¡rias vezes!	Negativa
Honestamente, Falta de informaÃ§Ãµes claras Muito bom!	Negativa
Sem dÃºvidas, ExperiÃªncia de compra maravilhosa Muito bom!	Positiva
Com certeza, PÃ©ssima experiÃªncia, nÃ£o recomendo Recomendo!	Negativa
Honestamente, Atendimento ao cliente deixou a desejar!	Negativa
Honestamente, Produto veio com defeito.	Negativa
Com certeza, Voltarei a comprar com certeza Muito bom!	Positiva
Entrega muito lenta.	Negativa
Honestamente, Suporte muito atencioso e prestativo.	Positiva
Sem dÃºvidas, Produto chegou em perfeito estado Recomendo!	Positiva
O produto Ã© exatamente como descrito.	Positiva
Comprei e fiquei muito feliz ğŸ˜Š	Positiva
Atendimento ruim e pouco eficiente Recomendo!	Negativa
Sem dÃºvidas, NÃ£o resolveram meu problema!	Negativa
Honestamente, Atendimento ao cliente deixou a desejar.	Negativa
Sem dÃºvidas, Fiquei decepcionado com a compra!	Negativa
Sem dÃºvidas, Gostei muito da qualidade do produto Recomendo!	Positiva
Honestamente, NÃ£o resolveram meu problema.	Negativa
Honestamente, Produto superou minhas expectativas.	Positiva
Sem dÃºvidas, Fiquei muito satisfeito com o atendimento.	Positiva
Honestamente, Site com muitas falhas, difÃ­cil comprar!	Negativa
Honestamente, PÃ©ssima experiÃªncia, nÃ£o recomendo!	Negativa
Sem dÃºvidas, Recomendo a todos.	Positiva
Com certeza, Gostei muito da qualidade do produto!	Positiva
Honestamente, Suporte tÃ©cnico resolveu meu problema rÃ¡pido!	Positiva
Entrega atrasada, fiquei frustrado!	Negativa